[
  {
    "id": "l1",
    "name": "入门 1",
    "rows": [
      "#######",
      "###..P#",
      "#.T.T.#",
      "#..BB##",
      "###..##",
      "###..##",
      "#######"
    ]
  },
  {
    "id": "l2",
    "name": "入门 2",
    "rows": [
      "########",
      "#...#P.#",
      "#....B*#",
      "#####.T#",
      "########"
    ]
  },
  {
    "id": "l3",
    "name": "入门 3",
    "rows": [
      "#######",
      "#....P#",
      "#.#T#.#",
      "#..*B.#",
      "###..##",
      "###..##",
      "#######"
    ]
  },
  {
    "id": "l4",
    "name": "入门 4",
    "rows": [
      "######",
      "#P..T#",
      "#..B*#",
      "###..#",
      "###..#",
      "######"
    ]
  },
  {
    "id": "l5",
    "name": "入门 5",
    "rows": [
      "######",
      "#...T#",
      "#..BB#",
      "###T.#",
      "###.P#",
      "######"
    ]
  },
  {
    "id": "l6",
    "name": "入门 6",
    "rows": [
      "#######",
      "#..P###",
      "#.#T..#",
      "#..*B.#",
      "#...###",
      "##..###",
      "#######"
    ]
  },
  {
    "id": "l7",
    "name": "入门 7",
    "rows": [
      "######",
      "#...##",
      "#....#",
      "##*..#",
      "##TB##",
      "##.P##",
      "######"
    ]
  },
  {
    "id": "l8",
    "name": "入门 8",
    "rows": [
      "#####",
      "#..P#",
      "#.BT#",
      "##.T#",
      "##B.#",
      "##..#",
      "##..#",
      "#####"
    ]
  },
  {
    "id": "l9",
    "name": "入门 9",
    "rows": [
      "########",
      "#...T.P#",
      "#.B....#",
      "#####*.#",
      "#####..#",
      "########"
    ]
  },
  {
    "id": "l10",
    "name": "入门 10",
    "rows": [
      "######",
      "#..###",
      "#..B.#",
      "#*P..#",
      "#..###",
      "#.T###",
      "######"
    ]
  }
]
