[
  {
    "id": "m1",
    "name": "中等 1",
    "rows": [
      "########",
      "#PB.*T##",
      "#...#..#",
      "##*.*.T#",
      "##..#.##",
      "###..B.#",
      "####...#",
      "########"
    ]
  },
  {
    "id": "m2",
    "name": "中等 2",
    "rows": [
      "#########",
      "###..####",
      "###..####",
      "#..*.##T#",
      "#.#.**..#",
      "#....*#.#",
      "###B#P#.#",
      "###.....#",
      "#########"
    ]
  },
  {
    "id": "m3",
    "name": "中等 3",
    "rows": [
      "########",
      "#.....##",
      "#.#T#.##",
      "#.BPB.##",
      "###T#.##",
      "##TT*B.#",
      "###B#..#",
      "###....#",
      "########"
    ]
  },
  {
    "id": "m4",
    "name": "中等 4",
    "rows": [
      "#########",
      "#####...#",
      "#####B#.#",
      "##..B...#",
      "#P.BBB.T#",
      "#TTTT####",
      "#########"
    ]
  },
  {
    "id": "m5",
    "name": "中等 5",
    "rows": [
      "########",
      "#.....##",
      "#.T*..##",
      "#.*.#P.#",
      "#.T*BB.#",
      "#.....##",
      "########"
    ]
  },
  {
    "id": "m6",
    "name": "中等 6",
    "rows": [
      "######",
      "#TTTT#",
      "#..BT#",
      "#.BB.#",
      "##.#B#",
      "#.B..#",
      "#..P.#",
      "######"
    ]
  },
  {
    "id": "m7",
    "name": "中等 7",
    "rows": [
      "##########",
      "#......TT#",
      "#...##BTT#",
      "##B.B.BT##",
      "##..#..B##",
      "######P.##",
      "##########"
    ]
  },
  {
    "id": "m8",
    "name": "中等 8",
    "rows": [
      "######",
      "#T.PT#",
      "#B.*.#",
      "#.BBB#",
      "#T..T#",
      "######"
    ]
  },
  {
    "id": "m9",
    "name": "中等 9",
    "rows": [
      "#########",
      "#PTTTTT.#",
      "#.BBBBB.#",
      "#...#...#",
      "#####...#",
      "#########"
    ]
  },
  {
    "id": "m10",
    "name": "中等 10",
    "rows": [
      "#########",
      "#.TTTTT.#",
      "#.BBBBB.#",
      "#...#...#",
      "#P.##..##",
      "#########"
    ]
  }
]
