[
  {
    "id": "e1",
    "name": "简单 1",
    "rows": [
      "########",
      "###...##",
      "##.B#.##",
      "#..T..##",
      "#...#.##",
      "#.BB#T.#",
      "###PT..#",
      "########"
    ]
  },
  {
    "id": "e2",
    "name": "简单 2",
    "rows": [
      "########",
      "#..T.TT#",
      "#..#.B.#",
      "#.B.B.##",
      "##P.####",
      "########"
    ]
  },
  {
    "id": "e3",
    "name": "简单 3",
    "rows": [
      "########",
      "#..#####",
      "#.*#..##",
      "#PB..T##",
      "#TB#...#",
      "##.....#",
      "########"
    ]
  },
  {
    "id": "e4",
    "name": "简单 4",
    "rows": [
      "########",
      "#####..#",
      "#####..#",
      "#T..*P.#",
      "#.#.B..#",
      "#.#.##*#",
      "#......#",
      "########"
    ]
  },
  {
    "id": "e5",
    "name": "简单 5",
    "rows": [
      "########",
      "#####..#",
      "#####..#",
      "#T..T..#",
      "#.#..B.#",
      "#.#B##*#",
      "#..P...#",
      "########"
    ]
  },
  {
    "id": "e6",
    "name": "简单 6",
    "rows": [
      "######",
      "#...##",
      "#..P.#",
      "#.#B.#",
      "#.T*T#",
      "###B.#",
      "###..#",
      "######"
    ]
  },
  {
    "id": "e7",
    "name": "简单 7",
    "rows": [
      "#########",
      "##...####",
      "#..#P####",
      "#.#.B..##",
      "#..T*T..#",
      "##..B.#.#",
      "####.#..#",
      "####...##",
      "#########"
    ]
  },
  {
    "id": "e8",
    "name": "简单 8",
    "rows": [
      "#########",
      "#...#####",
      "#.#.B.###",
      "#.PT*T..#",
      "###.B.#.#",
      "#####...#",
      "#########"
    ]
  },
  {
    "id": "e9",
    "name": "简单 9",
    "rows": [
      "########",
      "#####..#",
      "##..#..#",
      "##.TP..#",
      "##B*T.##",
      "#..B.###",
      "#...####",
      "########"
    ]
  },
  {
    "id": "e10",
    "name": "简单 10",
    "rows": [
      "########",
      "##...###",
      "##....##",
      "####T.##",
      "#..B*T.#",
      "#.#PB..#",
      "#...####",
      "########"
    ]
  }
]
